20 5 10
7 10
+.||---P.|
-|--PX-|||
|-|.-|+||-
+--.+P.--.
-|-|-|--|F
.+P|.++-||
|--+-----+
